No,"Total no. of subjects 
at top levels / grades","Candidates with the corresponding results in 
Category A/B/C subjects - No. of Male","Candidates with the corresponding results in 
Category A/B/C subjects - % of Male","Candidates with the corresponding results in 
Category A/B/C subjects - No. of Female","Candidates with the corresponding results in 
Category A/B/C subjects - % of Female","Candidates with the corresponding results in 
Category A/B/C subjects - Total No.","Candidates with the corresponding results in 
Category A/B/C subjects - Total %","Candidates with the corresponding results in 
Category A subjects - No. of Male","Candidates with the corresponding results in 
Category A subjects - % of Male","Candidates with the corresponding results in 
Category A subjects - No. of Female","Candidates with the corresponding results in 
Category A subjects - % of Female","Candidates with the corresponding results in 
Category A subjects - Total No.","Candidates with the corresponding results in 
Category A subjects - Total %"
1,8,1,0.0 ,0,0.0 ,1,0.0 ,1,0.0 ,0,0.0 ,1,0.0 
2,7,6,0.0 ,4,0.0 ,10,0.0 ,6,0.0 ,4,0.0 ,10,0.0 
3,6,15,0.1 ,13,0.1 ,28,0.1 ,15,0.1 ,13,0.1 ,28,0.1 
4,5,32,0.1 ,16,0.1 ,48,0.1 ,31,0.1 ,16,0.1 ,47,0.1 
5,4,34,0.1 ,39,0.2 ,73,0.1 ,34,0.1 ,38,0.2 ,72,0.1 
6,3,114,0.5 ,87,0.3 ,201,0.4 ,109,0.4 ,84,0.3 ,193,0.4 
7,2,187,0.7 ,216,0.9 ,403,0.8 ,190,0.8 ,208,0.8 ,398,0.8 
8,1,803,3.2 ,1145,4.5 ,1948,3.9 ,663,2.6 ,829,3.3 ,1492,3.0 
9,0,24064,95.3 ,23671,94.0 ,47735,94.6 ,24153,95.8 ,23948,95.3 ,48101,95.5 
10,Total,25256,100.0 ,25191,100.0 ,50447,100.0 ,25202,100.0 ,25140,100.0 ,50342,100.0 
